##############
#............#
##..###......#
##.####.#....#
...#..#.#....#
###...#.#....#
#...#...#....#
#"########...#
#............#
############.#
