#:  P: player, C: cherry, S: stone, W: Stone
####D#WWW###DDD
WWWWWWWWW#G#DDD
######WWW###DDD
###G##WWW###G#D
SSSSSSS#######D
SWWWWSGDDDDDDDD
S###WSDDDDDDGDD
SS##WSDDGDDSSDD
#S##WSSSSSSSKDD
#P##WWWWGSSSSSS
####WWWW#SSSGSS
