#: grass, G: green gem
#G#######G##G##
###B###G#######
####K#####B#G##
#######G####G##
#W#######G#P###
##WW#G##G######
#GWWW#######G##
###WWW####G####
###############
#######G#######
####G#######G##
