#:stone, B: block, C: Cherry
#####DB########
#B#B#DB##B#B###
#####D######G##
#####C##P###G##
BB###BBB###BBB#
######B#G######
#G##########G##
#B#B#G###B#B###
######B########
######BD#######
####G#######G##
