#:stone, B: block, C: Cherry
######B########
#B#B##B##B#B###
###############
#####C##P######
BB###BBB###BBB#
######B########
#####D#########
#B#B#####B#B###
######B########
##G###B########
###############
