#:stone, B: block, C: Cherry
######B########
#B#B##B##B#B###
###############
#####C##P######
BB###BBB###BBB#

#######B#######
######G########
#B#B#####B#B###
######B########
#G####BD#######
