#:stone, B: block, C: Cherry
#####DB########
#B#B#DB##B#B###
##G##D######G##
#####C##P###G##
BB###BBB###BBB#
##G###B#G######
###############
#B#B#####B#B###
######B########
######BD#######
####G#######G##
