#: grass, G: green gem
#G#######G##G##
###B###G#######
####K#####B#G##
#######G####G##
#W#######G#P###
##W##G##G######
#GWW########G##
###W#G####G####
WWWW###########
#######G#######
####G#######G##
