#:stone, B: block, C: Cherry
#####DB########
#B#B#DB##B#B###
#####D#########
#####C##P######
BB###BBB###BBB#
#######B#######
######G########
#B#B#####B#B###
######B########
#G####BD#######
###############
